107
8
22 00 00 00 00 00 00 00 00 00 00 00 00 00 00 00 0 0 00 0 0 00 00 00 00 00 00 00 00 00 00 00 00 00 00 00 00 00 0 00 00 00 0 0 22 22 22 22 22 22 22 22 22 22 22 22 22 22 22 22 22 22 22 22 22 22 22 22 22 22 22 22 22 22 22 00 00 00 00 00 00 00 00 00 00 00 00 00 00 00 00 22 22 22 22 22 22 22 22 22 22 22 22 22 22 22 22
22 00 00 00 00 00 00 00 00 00 00 00 00 00 00 00 0 0 00 0 0 00 00 00 00 00 00 00 00 00 00 00 00 00 00 00 00 00 0 00 00 00 0 0 00 22 22 22 22 22 22 22 22 22 22 22 22 22 22 22 22 22 22 22 22 22 22 22 22 22 22 22 22 22 22 00 00 00 00 00 00 00 00 00 00 00 00 00 00 00 00 22 22 22 22 22 22 22 22 22 22 22 22 22 22 22 22
22 00 00 00 00 00 00 00 00 00 00 00 00 00 00 00 0 0 00 0 0 00 00 00 00 00 00 00 00 00 00 00 00 00 00 00 00 00 0 00 00 00 0 0 00 00 22 22 22 22 22 22 22 22 22 22 22 22 22 22 00 00 00 00 00 00 00 00 00 00 00 22 22 22 22 00 00 00 00 00 00 00 00 00 00 00 00 00 00 00 00 00 22 22 22 22 00 00 00 00 00 00 00 00 00 00 22
22 00 00 00 00 00 00 00 00 00 00 00 00 00 00 00 0 0 00 0 0 00 00 00 00 00 00 00 00 00 00 00 00 00 00 00 00 00 0 21 21 21 0 0 00 00 00 00 00 00 00 22 22 22 22 22 22 22 22 22 00 00 00 00 00 00 00 00 00 00 00 00 00 22 22 00 00 00 00 00 00 00 00 00 00 21 00 00 00 00 00 00 00 22 22 22 00 00 00 00 00 00 00 00 00 00 22
22 00 00 00 00 00 00 00 00 00 00 00 00 00 21 21 0 0 00 0 0 00 00 00 00 00 00 00 00 00 00 00 00 21 21 00 00 00 0 00 00 00 0 0 00 00 00 00 00 00 00 00 00 00 00 00 00 00 00 00 00 00 00 21 21 00 00 00 00 00 00 00 00 00 00 00 00 00 00 21 21 21 00 00 00 22 00 00 00 00 00 00 00 00 22 22 00 00 00 00 00 00 00 00 00 00 22
22 0 00 00 00 00 00 00 00 00 00 21 21 21 21 22 0 0 00 0 0 00 00 00 00 00 00 00 00 00 00 00 00 00 00 00 00 00 0 00 00 00 0 0 21 21 21 21 00 00 00 00 00 00 00 00 00 00 00 00 00 00 22 22 22 00 00 00 00 00 00 00 00 00 00 00 00 00 00 00 00 00 00 00 00 22 00 00 00 00 00 00 00 00 00 00 00 00 00 00 00 00 00 00 00 00 22
22 00 00 00 00 00 00 00 00 00 00 22 22 22 22 22 0 0 00 0 0 21 21 21 00 00 00 00 00 00 21 21 00 00 00 00 21 21 0 00 00 00 0 0 22 22 22 22 00 00 00 00 21 00 00 00 00 21 00 00 00 21 21 22 22 00 00 00 00 00 00 00 00 00 00 00 00 21 00 00 00 00 00 00 00 22 21 00 00 00 00 21 00 00 00 00 00 00 00 00 00 00 00 00 00 00 22
21 21 21 21 21 21 21 21 21 21 21 21 22 22 22 22 0 0 00 0 0 22 22 22 21 21 21 21 21 21 21 21 21 21 21 21 21 22 0 00 00 00 0 0 22 22 22 21 21 21 21 21 21 21 21 21 21 21 21 21 21 21 22 22 22 00 00 00 00 00 00 21 21 21 21 21 21 21 21 21 21 21 21 21 21 22 21 21 21 21 21 21 21 21 00 00 00 00 21 21 21 21 21 21 21 21 21
